10
-.-.-.-.-.-.-.-.-.-
-.-.-.-.-.-.-.P.-.-
-.-.-.-.-.-.-.-.W.-
-.P.H_P.-.-.-.P_G.-.-.-
-.-.W.-.-.G.-.-.-.-
W.H_P.-.-.-.-.-.-.-.-
-.-.-.-.-.-.W.-.-.-
-.-.-.-.-.-.-.-.P.-
-.H_P.-.-.-.-.-.-.-.H_P
A.-.W.-.-.-.-.-.-.-







