10
A.-.W.P_G.-.-.-.-.-.-.-
-.P.-.-.-.-.-.W.-.H_P.-
-.-.-.-.-.-.-.P.-.-.-.-
-.H_P.-.-.G.W.-.-.-.-.-
W.-.-.-.-.-.-.P_G.-.-.-
-.-.W.-.-.-.-.P.-.-.-.-
-.P.-.-.-.H_P.-.W.P.-.-
-.-.-.P_G.-.-.-.-.-.G
-.W.-.-.-.-.-.P_G.-.-.-
-.P.-.-.-.-.H_P.-.-.-.-
