10
-.P.-.-.-.-.-.-.P.-.-
-.W.-.P.-.-.-.-.G.-.-
-.-.-.-.-.-.W.-.-.-.-
-.W.-.-.P_G.-.-.-.-.-
P.-.-.-.-.-.-.-.-.H_P
-.-.-.-.-.-.-.-.-.-.-
-.H_P.-.-.-.-.-.-.-.- 
W.-.-.-.P.-.-.-.G.-.-
-.W.P_G.-.-.-.-.P.-.-
A.-.-.-.-.-.-.-.-.-.-
