10
-.P.-.-.-.-.-.P.-.-.-
H_P.-.W.-.-.P.-.-.-.-
-.G.-.-.-.-.-.-.-.P.-
-.W.-.-.P_G.-.-.H_P.-
P.-.-.-.-.-.-.P_G.-.-
-.-.-.-.-.-.-.W.-.-.-
-.W.-.-.-.-.-.-.-.G.-
-.H_P.-.-.-.-.-.-.-.-
-.P.-.-.P_G.-.-.-.-.-
A.-.-.-.-.-.-.-.-.-.-
