10
-.-.-.-.-.-.G.-.-.-.-
-.P.-.-.-.-.-.-.-.P_G
-.-.-.-.-.-.-.-.-.-.-
-.-.-.-.-.-.P.-.H_P.-
-.-.-.-.-.W.-.-.-.-.-
-.-.-.-.-.-.-.-.-.-.-
-.-.-.H_P.-.-.-.-.-.-
-.-.-.-.W.-.-.-.G.-.-
-.-.P.-.-.-.-.-.-.-.-
A.-.-.-.-.-.P_G.-.-.-


