10
A.-.-.-.-.-.-.W.P.-.G
-.P_G.-.-.-.-.-.-.-.-.-
-.-.-.-.W.-.-.-.-.-.-.-
-.P.-.-.W.-.-.-.-.-.-.-
-.H_P.-.-.-.-.P.-.-.-.-
-.-.-.-.-.-.-.-.-.-.-
-.P.-.-.-.-.-.-.W.-.-.-
-.W.P_G.-.-.-.P.-.-.G
-.-.-.-.-.-.-.H_P.-.-.-
-.-.-.-.-.-.-.-.-.-.-
