10
-.-.-.-.-.-.-.-.-.-
-.-.-.-.-.-.-.-.P.-
-.-.-.-.-.-.P.-.W.-
-.-.-.P.-.-.P.-.-.-
-.-.-.-.-.-.-.G.-.-
-.P.-.P_G.-.-.-.-.-
-.-.-.-.-.-.H_P.-.-
-.-.P.-.-.-.-.-.-.-
-.H_P.G.W.-.-.-.-.-
A.-.-.-.-.-.-.-.-.-
