10
A.-.-.-.W.-.P_G.-.-.-
-.P.-.-.-.-.-.-.P.-.G
-.-.-.-.-.-.W.-.-.-.-
-.W.-.-.-.-.-.-.-.P.-
-.-.-.-.-.H_P.-.P.-.-.-
-.P.-.W.-.-.-.-.-.-.-
-.-.-.-.P.-.-.-.W.P.-
-.-.-.-.-.P_G.-.H_P.-
-.-.-.-.-.-.-.-.-.-.-
-.P.-.-.-.-.G.-.-.-.-
