10
-.P_G.-.-.-.-.-.-.-.-.-
-.W.-.P.-.-.-.-.-.-.-.-
-.H_P.-.W.-.-.-.P.-.-.-
P.-.-.-.-.-.-.W.-.-.-
-.W.-.-.H_P.-.-.-.-.-
-.-.-.-.G.-.-.-.P.-.-.-
-.P.-.-.-.-.-.-.-.-.-.-
-.H_P.-.-.P_G.-.-.W.-.-
-.W.-.-.-.-.-.-.-.-.-.-
A.-.-.-.-.-.-.-.-.-.-
