10
P.-.W.P_G.-.-.-.-.-.-
-.P.-.-.-.-.-.W.-.H_P
-.-.-.-.-.-.-.P.-.-
-.H_P.-.-.G.W.-.-.-.-
W.-.-.-.-.-.-.P_G.-.-
-.-.W.-.-.-.-.P.-.-
-.P.-.-.-.H_P.-.W.P.-
-.-.-.P_G.-.-.-.-.-.G
-.W.-.WW.-.G.-.P_G.-.-
A.P.-.-.-.H_P.-.-.-.-