10
A.-.-.-.-.-.P.-.-.-.-
P.-.W.-.-.-.-.H_P.-.-
-.G.-.-.-.-.-.-.-.-.P
-.P.-.-.-.P_G.-.W.-.-
-.W.-.-.-.-.H_P.-.-.-.-
-.-.-.-.-.-.-.-.-.-.-
-.P.-.-.-.-.-.-.-.-.-.-
-.H_P.-.-.-.W.P.-.-.G
-.-.-.-.-.-.-.-.-.P.-
-.-.-.P.-.-.-.-.-.-.-
