10
A.-.-.-.-.-.-.P.-.-.-.-
-.P.-.W.-.-.H_P.-.-.-.-
-.-.-.P_G.-.-.-.-.-.G.-
-.W.-.-.-.-.-.-.-.-.-.-
P.-.-.-.-.-.-.W.-.-.-.-
-.H_P.-.-.-.P.-.-.-.W.-
-.P_G.-.-.-.-.-.-.-.-.-
-.-.-.-.-.-.-.-.-.-.-
-.W.-.-.-.-.-.-.-.-.-.-
-.P.-.-.-.-.-.-.-.-.-.-
