10
-.P_G.-.-.-.H_P.-.-.W.-
A.-.-.-.-.-.-.-.-.-.-.-
-.P.-.-.-.W.-.-.P.-.-.-
-.-.-.-.P.-.-.-.-.-.-.-
-.H_P.-.-.-.-.G.-.-.W.-
-.P.-.-.W.-.-.-.P.-.H_P.-
-.-.-.-.P_G.-.-.-.-.-.-
-.H_P.-.-.-.W.-.P.-.-.-
-.-.-.-.-.-.-.-.-.P.-.-
-.P.-.-.-.-.-.-.G.-.-.-.-
